{
	"name": "Fallout",
	"reverses": 16,
	"layout": [
	[4, 5, 5, 3, 3, 2, 2, 2],
	[4, 5, 3, 3, 2, 4, 4, 5],
	[2, 3, 5, 5, 5, 1, 4, 4],
	[2, 3, 3, 2, 3, 4, 5, 3],
	[4, 4, 5, 2, 3, 4, 5, 3],
	[3, 2, 3, 3, 3, 3, 2, 5],
	[3, 4, 0, 2, 3, 3, 4, 5],
	[2, 3, 3, 4, 5, 3, 4, 5]
	]
}
